...........................
...........................
......C....................
...........................
....WWWWWWWWWWWWWW...WW....
....W...C....w........W....
....W........w......C.W....
....W........w........W....
....W........w........W....
....Wwwww.............W....
....W.................W....
....W........w........w..C.
........wwwwwwwwwww...w....
.............w.C......w....
....W........w........W....
....W.................W....
....W.................W....
....WWWWWWWWWWWWW.....W....
....W...........w.....W.C..
.C..W..C...wwwww......W....
....W...............C.W....
....W.................W....
....WWWWWWWwwwwwWWWWWWW....
...........................
....................C......
.......C...................
...........................
